########################################
#--------------------------------------#
#--------------------------------------#
#--------------------------------------#
#--------------------------------------#
#----********--------------------------#
#----*------*----------**********------#
#----*--**--*----------*--------*------#
#----*--**--*----------*--****--*------#
#----*------*----------*--*--*--*------#
#----********----------*--****--*------#
#----------------------*--------*------#
#----------------------**********------#
#--------------------------------------#
#----------********--------------------#
#----------*------*--------------------#
#--*********--**--**********-----------#
#--*--------*--*--*--------*-----------#
#--*--****--*--*--*--****--*-----------#
#--*--*--*--*--*--*--*--*--*-----------#
#--*--****--*--*--*--****--*-----------#
#--*--------*--*--*--------*-----------#
#--*********--**--**********-----------#
#--------------------------------------#
#-------------------**********---------#
#-------------------*--------*---------#
#-------------------*--****--*---------#
#-------------------*--------*---------#
#-------------------**********---------#
########################################
