########################################
#--------------------------------------#
#--------------------------------------#
#--------------------------------------#
#--------------------------------------#
#----********--------------------------#
#----*------*----------**********------#
#----*--**--*----------*--------*------#
#----*--**--*----------*--****--*------#
#----*------*----------*--*--*--*------#
#----********----------*--****--*------#
#----------------------*--------*------#
#----------------------#################
#----------------------#---------------#
#----------********----#---------------#
#----------*------*----#---------------#
#--*-------*--**--**####****-----------#
#--*-----------------------*-----------#
#--*-----------*-----------*-----------#
#--------------------------------------#
#--*-----------------------------------#
#--*-----------------------------------#
#--*######-----------------------------#
#--------------------------------------#
#-------------------##########---------#
#-------------------*--------*---------#
#-------------------*--****--*---------#
#-------------------*--------*---------#
#-------------------##########---------#
########################################
