########################################
#--------------------------------------#
#--------------------------------------#
#--------------------------------------#  
#--------------------------------------# 
#----------***********-----------------#
#----------*-----------*---------------#
#----------*-----------*---------------#  
#----*****--*-----------*--*****-------#  
#--------------------------------------# 
#--------##########--------------------#
#--------------------------------------# 
#----------***********-----------------#
#----------*-----------*---------------#
#----------*-----------*---------------#
#----*****--*-----------*--*****-------#  
#--------------------------------------#  
#------------------------------#########
#--------------------------------------#
#----------***********-----------------#
#----------*-----------*---------------#
#----------*-----------*---------------#
#----*****--*-----------*--*****-------#
#--------------------------------------#
#--------------------------------------# 
#--------------------------------------#
#----------##########------------------#
#--------------------------------------# 
#--------------------------------------#  
########################################
