########################################
#--------------------------------------#
#--------------------------------------#
#--------------------------------------#
#--------------------------------------#
#-----#**----#**-----#**----#**--------#
#-----**#----**#-----**#----**#--------#
#--------------------------------------#
#--------------------------------------#
#--------------------------------------#
#-----***#***-----***#***--------------#
#-----*#*#*#*-----*#*#*#*--------------#
#-----***#***-----***#***--------------#
#--------------------------------------#
#--------------------------------------#
#-----#**#**-----#**#**----------------#
#-----**##**-----**##**----------------#
#--------------------------------------#
#--------------------------------------#
#-----***#***-----***#***--------------#
#-----*#*#*#*-----*#*#*#*--------------#
#-----***#***-----***#***--------------#
#--------------------------------------#
#--------------------------------------#
#-----#**----#**-----#**----#**--------#
#-----**#----**#-----**#----**#--------#
#--------------------------------------#
#--------------------------------------#
########################################