########################################
#--------------------------------------#
#--------------------------------------#
#--------------------------------------#
#--------------------------------------#
#-----#**----#**-----#**----#**--------#
#-----**#----**#-----**#----**#--------#
#--------------------------------------#
#--------------------------------------#
#--------------------------------------#
#-----***#***-----***#***------------#
#-----*#*#*#*-----*#*#*#*------------#
#-----***#***-----***#***------------#
#--------------------------------------#
#--------------------------------------#
#-----#**#**-----#**#**--------------#
#-----**##**-----**##**--------------#
#--------------------------------------#
#--------------------------------------#
#-----***#***-----***#***------------#
#-----*#*#*#*-----*#*#*#*------------#
#-----***#***-----***#***------------#
#--------------------------------------#
#--------------------------------------#
#-----#**----#**-----#**----#**--------#
#-----**#----**#-----**#----**#--------#
#--------------------------------------#
#--------------------------------------#
########################################